
MAZE: "mylevel", ' '
FLAGS:premapped
GEOMETRY:center,center

MAP
|||||||||
|.......|
|...---.|
|...|...|
|.---...|
|.......|
|||||||||
ENDMAP

STAIR:(7, 1),down

BRANCH: (1,3,1,3),(2,4,2,4)