
MAZE: "mylevel", ' '
FLAGS:premapped
MESSAGE:"This is a hard maze... good luck bitch."
GEOMETRY:center,center

MAP
||||||||||||||||||||
|.......|.|........|
|.-----.|.|.-----|.|
|.|...|.|.|......|.|
|.|...|.|.|-----.|.|
|.|.|...|....|.|.|.|
|.|.--------.|.|.|.|
|.|..........|...|.|
|.|--------------|.|
|..................|
|....|||||.........|
|....|.............|
||||||||||||||||||||                   
ENDMAP

STAIR:(14, 5),down

BRANCH: (1,11,1,11),(4,3,4,3)
